14	[CD]
16th	[JJ]
3	[LS]
49	[CD]
6	[CD]
60	[CD]
a-	[NNP]
adultery	[NN]
aghh	[NNP]
album	[NN]
algebra	[NNP]
alibi	[NN]
allow	[VBP]
almost	[RB]
aluminum	[NN]
ambition	[NNS]
answer	[NNS]
appear	[VB]
appearance	[NNS]
appointment	[NN]
appreciate	[VB]
artist	[NN]
ash	[NNP]
ashley	[NNP]
ask	[VBP]
assume	[VBG, VBP]
audience	[NN]
audio	[JJ]
aunt	[NNP]
backhand	[NN]
balance	[NN]
baptism	[NN]
bearing	[NN]
beat	[VB]
beautiful	[NNP]
begin	[VBD]
behavior	[NN]
belief	[NNS]
believe	[NNP]
bep	[NN]
better	[RBR]
between	[IN]
bigger	[JJR]
bike	[NN]
biology	[NN]
bitterness	[NN]
blue	[NN]
book	[VBN]
boot	[NN]
bottom	[JJ]
bounce	[VBG]
brain	[NN]
braised	[JJ]
brandi	[NNP]
bre	[NNP]
bread	[NN]
break	[VB, VBD, VBP]
brother	[NNS]
build	[VBN]
bukowski	[NNP]
businessman	[NN]
cabin	[NN]
cable	[NN]
calm	[VBN]
camp	[NN]
can	[NNS]
cancel	[VB]
cancun	[NNP]
card	[NNS]
care	[VBP]
carry	[VB]
casual	[JJ]
catch	[VBD, VBN]
challenge	[NN]
change	[NN]
chatty	[NN]
chest	[NN]
childish	[JJ]
chill	[VB]
choice	[NN]
church	[NN]
cigar	[NN]
city	[NNS]
clicking	[NNP]
client	[NN]
club	[NN]
coffe	[NN]
collection	[NNS]
college	[NN]
complete	[JJ]
completely	[RB]
concoct	[VBN]
confession	[NNS]
confidence	[NN]
confuse	[VB]
contain	[VBG]
counsel	[VBG]
counseling	[NN]
couple	[NN, NNS]
cover	[VB, VBG]
crack	[VBD]
crash	[VBG]
cross	[NN]
cruise	[VBG]
cry	[VB, VBZ]
cut	[VB]
d	[SYM]
damn	[JJ, NN]
dancing	[NN]
date	[VBG]
daughter	[NN]
deal	[VB]
decorate	[VBG]
dental	[JJ]
depend	[VBZ]
desire	[NNS]
despise	[VBN]
detail	[NN]
diamond	[NNS]
die	[VBG, VBZ]
different	[JJ]
dillman	[NNP]
direction	[NNS]
disappear	[VBP]
discard	[VBN]
disneyland	[NNP]
doh	[NNP]
doubt	[NNS]
dress	[NN]
drink	[VBP]
drinking	[NN]
drive	[VBG]
driveway	[NN]
drop	[NN, VBP]
earlier	[RBR]
early	[RB]
eat	[VBG]
eight	[CD]
ejaculate	[NNS]
elegance	[NN]
else	[RB]
end	[NN, NNS, VBD]
engagement	[NN]
enjoy	[VBP]
entirely	[RB]
escrow	[NNP]
eternity	[NN]
everybody	[NN]
exam	[NN]
excite	[VBN]
exercise	[NN]
exhausting	[JJ]
exhaustion	[NN]
exist	[VBD]
extra	[JJ]
eye	[NN]
face	[VBP]
fall	[NN, VBD]
favor	[NN]
fear	[NN, NNS]
fight	[VBG]
figure	[VB]
find	[VBG]
fine	[NNP]
fish	[NN, VBG]
fix	[NN]
flamingos	[NNP]
flat	[JJ]
flattering	[JJ]
flip	[JJ]
foam	[NN]
for	[RP]
forget	[VB, VBG, VBN]
found	[NNP]
frame	[NN]
frat	[NN]
free	[JJ]
front	[JJ]
gal	[NN]
gang	[NN]
gentle	[JJ]
gentleman	[NN, NNS]
girl	[NN]
glass	[NN]
glove	[NNS]
go	[VBZ]
golden	[JJ]
good	[NN]
got	[NNP]
grandpa	[NN]
grandson	[NN]
green	[JJ]
grisly	[JJ]
group	[NN]
grown-ups	[JJ]
guarantee	[VB]
guard	[NN]
gym	[NN]
half	[PDT]
half-hour	[NN]
hand	[NNS]
handle	[VB]
handle-bar	[JJ]
hang	[VB]
happen	[VBG]
hat	[NN]
hate	[VBP]
have	[VBN]
hawaiian	[JJ]
head	[NN]
hear	[VB]
heat	[NN]
heck	[NN]
heel	[NNS]
help	[VBG, VBZ]
high	[JJ]
hmm	[NNP]
hold	[VB, VBD]
honestly	[NNP]
honey	[NNP]
honor	[NN, VB]
hors	[NNS]
host	[VBG]
hostess	[NNS]
hotel	[NN]
house	[NNS]
humanity	[NN]
humiliated	[JJ]
humiliating	[JJ]
humiliation	[NN]
hungry	[JJ]
husband	[NNS]
hyper	[JJ]
ice	[NN]
idea	[NNS]
improve	[VBG]
in	[RP]
insight	[NN]
internet	[NN]
interrupt	[VB]
interstate	[NN]
investigator	[NNS]
invite	[VBN]
ionely	[NNP]
ioud	[NNP]
issue	[NN]
jam	[NN]
jar	[NN]
jealous	[JJ]
jogging	[NN]
joke	[NNS]
kaha	[NNP]
kill	[NN]
kind	[NNP]
kiss	[NNS, VBG]
knock	[NNP, VBG]
lake	[NNP]
lamb	[NN]
late	[RB]
laugh	[VB]
laughing	[NNP]
learn	[VBG, VBN]
least	[JJS]
leave	[VBP]
lesson	[NNS]
lewd	[NN]
light	[JJ, NN]
lightly	[RB]
like	[VBZ]
line	[NN]
lip	[NNS]
liquor	[NN]
little	[RB]
live	[VB, VBN, VBP]
local	[JJ]
lock	[VBD]
locked	[NNP]
lodge	[VB]
long	[RB]
loose	[JJ]
lovely	[JJ]
lua	[NN]
lying	[NNP]
mail	[NN]
main	[NNP]
make	[VBN]
mall	[NN]
manager	[NN]
margarita	[NNP]
maria	[NNP]
marital	[JJ]
match	[VB]
medication	[NN]
message	[NN, NNS]
miller	[NNP]
minus	[CC]
miss	[VBP]
monster	[NN]
moral	[JJ]
motor	[NN]
mouth	[NN]
move	[VBP]
mysterious	[JJ]
mystery	[NN]
nail	[NN]
naked	[JJ, NNP]
nana	[NNP]
near	[IN]
necessary	[JJ]
necklace	[NN]
need	[VBZ]
nemo	[NNP]
nerve	[NNS]
nice	[NNP]
notice	[NN, VB]
nowhere	[RB]
o'clock	[RB]
obituary	[JJ]
obviously	[RB]
occur	[VBD]
oeuvr	[NNS]
office	[NN]
okay	[JJ]
on	[RB]
one	[NN]
outlive	[JJ]
oven	[NN]
pack	[VBG, VBP]
page	[NN]
pamphlet	[NN]
pants	[NNP, NNS]
paradise	[NN]
part	[NNS]
partner	[NNS]
peek	[NN]
perp-walked	[JJ]
person	[NN]
pet	[NN]
petulant	[JJ]
photo	[NN]
pick	[VB]
picture	[NN]
plausible	[JJ]
point	[VBG]
pond	[NN]
pornography	[NN]
possibly	[RB]
pound	[VBG]
prepare	[VBG, VBN]
pretty	[NNP]
prince	[NN]
princess	[NNP]
private	[JJ]
pro	[FW]
problem	[NNP]
proposal	[NN]
prostitution	[NN]
protection	[NNP]
proud	[JJ]
public	[NN]
push	[VBD]
question	[NNS]
quick	[JJ]
rack	[VBD]
raise	[VBG]
rate	[NNS]
read	[VBD]
reality	[NN]
realize	[VBD, VBP]
recover	[VBD]
refine	[VBN]
regional	[JJ]
relax	[NNS, VB]
relive	[VBG]
remains	[NNS]
remembering	[NNP]
rend	[VB]
replace	[VB]
resolve	[VB]
responsibility	[NN]
retaliated	[JJ]
revelation	[NN]
ribbon	[NNS]
ride	[NN, NNS]
ridiculous	[JJ]
rockwater	[NNP]
royal	[JJ]
rule	[NN]
run	[VBP]
sad	[JJ]
sale	[NNS]
scanned	[JJ]
schedule	[VBN]
schooled	[JJ]
scoop	[VB]
scoot	[NN]
screen	[NN]
scum	[NN]
search	[VBD, VBG]
sec	[NN]
second	[NN]
section	[NN]
serve	[VB, VBN]
settle	[VBD]
sexy	[NNP]
shall	[NNP]
shank	[NNS]
share	[NN]
sheer	[JJ]
sheila	[NNP]
shindig	[NN]
shoe	[NNS]
shopping	[NN]
show	[VB]
shrub	[NNS]
shy	[JJ]
sigh	[NNS]
silverware	[NN]
sitter	[NN]
sky	[NN]
sleep	[NN, VB, VBG]
slowly	[RB]
snack	[NNS]
sniffs	[NNP]
snigger	[NNS]
snuck	[NN]
social	[JJ]
soda	[NN]
solve	[VBD, VBN]
sombrero	[NN]
someday	[RB]
someplace	[NN]
sometimes	[RB]
sound	[VBD]
source	[NN]
spa	[NN]
speech	[NN]
spiked	[JJ]
spokesman	[NN]
stand	[NNS]
stark	[JJ]
starter	[JJ]
stay	[NN, VBG]
sticky	[JJ]
storm	[VBD]
story	[NN, NNS]
street	[NNP]
study	[VBD]
such	[JJ]
sudden	[JJ]
suggest	[VBP]
suitcase	[NN]
sunday	[NNP]
sunset	[NN]
surprise	[NN, VBD]
surrender	[VB]
sweetie	[NN, NNP]
swimming	[NN]
swimsuit	[NN]
tape	[NN]
tear	[VBN]
television	[NNP]
ten	[CD]
tennis	[NN, NNP]
tense	[JJ]
terrorist	[NNS]
thankful	[JJ]
that	[RB]
thought	[NN, NNP]
three-speed	[JJ]
throw	[VBN]
tight	[JJ]
tired	[JJ]
toad	[NNP]
toaster	[NN]
top	[VB]
towards	[IN]
towel	[NN]
trace	[VB]
travel	[VB]
tune	[NN]
typical	[JJ]
ugly	[JJ]
uh-huh	[NNP]
uh-oh	[NNP]
unacceptable	[JJ]
uncalled	[JJ]
uncomfortable	[JJ]
understand	[VBP]
unethical	[JJ]
unpacked	[JJ]
unravel	[VBG]
unsettled	[JJ]
urge	[NN]
usa	[NNP]
use	[VB]
video	[NN]
wake	[NN]
walk	[VB, VBD]
wall	[NNS]
want	[VBG]
warmington	[NNP]
warmth	[NN]
wash	[VB]
waste	[NN]
watch	[NNP, VBP]
waterfall	[NN]
whine	[NN]
whispers	[NNP]
wife	[NNS]
wild	[JJ]
wind	[VBN]
wing	[NN]
wipe	[VBN]
within	[IN]
woman	[NNP]
wonder	[VB, VBP]
wooden	[JJ]
work	[VB, VBP]
works	[NNP]
worth	[NN]
ya	[PRP]
yard	[NN]
yesterday	[NN]
yours	[NNS]
